-2	82	36	-2	82	100	-2	82	100	-2	82	100	-2	82	100	-2	82	100	-2	82	100	-2	82	100	-2	82	100	-2	82	100	-2	82	100	-2	82	100	-2	82	100	-2	82	100	-2	82	100	-2	82	100	-2	82	100	-2	82	100	-2	82	100	-2	82	100	-2	82	100	-2	82	100	-2	82	100	-2	82	100	-2	82	100	-2	82	100	-2	82	100	-2	82	100	-2	82	100	-2	82	100	-2	82	100	-2	82	100	-2	82	100	-2	82	100	-2	82	100	-2	82	100	-2	82	100	-2	82	100	-2	82	100	-2	82	68
-2	90	1	-2	90	1	-2	90	1	-2	90	1	-2	90	1	-2	90	1	-2	90	1	-2	90	1	-2	90	1	-2	90	1	-2	90	1	-2	90	1	-2	90	1	-2	90	1	-2	90	1	-2	90	1	-2	90	1	-2	90	1	-2	90	1	-2	90	1	-2	90	1	-2	90	1	-2	90	1	-2	90	1	-2	90	1	-2	90	1	-2	90	1	-2	90	1	-2	90	1	-2	90	1	-2	90	1	-2	90	1	-2	90	1	-2	90	1	-2	90	1	-2	90	1	-2	90	1	-2	90	1	-2	90	1	-2	90	1
-2	90	4	-2	90	4	-2	90	4	-2	90	4	-2	90	4	-2	90	4	-2	90	4	-2	90	4	-2	90	4	-2	90	4	-2	90	4	-2	90	4	-2	90	4	-2	90	4	-2	90	4	-2	90	4	-2	90	4	-2	90	4	-2	90	4	-2	90	4	-2	90	4	-2	90	4	-2	90	4	-2	90	4	-2	90	4	-2	90	4	-2	90	4	-2	90	4	-2	90	4	-2	90	4	-2	90	4	-2	90	4	-2	90	4	-2	90	4	-2	90	4	-2	90	4	-2	90	4	-2	90	4	-2	90	4	-2	90	4
-2	16	17	-2	16	-111	-2	16	-111	-2	16	-111	-2	16	-111	-2	16	-111	-2	16	-111	-2	16	-111	-2	16	-111	-2	16	-111	-2	16	-111	-2	16	-111	-2	16	-111	-2	16	-111	-2	16	-111	-2	16	-111	-2	16	-111	-2	16	-111	-2	16	-111	-2	16	-111	-2	16	-111	-2	16	-111	-2	16	-111	-2	16	-111	-2	16	-79	-2	16	-75	-2	16	-11	-2	16	-11	-2	16	-11	-2	16	-11	-2	16	-11	-2	16	-11	-2	16	-11	-2	16	-43	-2	16	-47	-2	16	-111	-2	16	-111	-2	16	-77	-2	25	-39	-2	25	-127
-2	16	0	-2	16	0	-2	16	32	-2	16	36	-2	16	100	-2	16	100	-2	16	100	-2	16	100	-2	16	100	-2	16	100	-2	16	100	-2	16	68	-2	16	64	-2	16	0	-2	16	0	-2	16	0	-2	16	0	-2	16	0	-2	16	0	-2	16	0	-2	16	0	-2	16	0	-2	16	0	-2	16	0	-2	16	34	-2	52	9	-2	52	1	-2	52	1	-2	52	1	-2	52	1	-2	52	1	-2	52	1	-2	52	1	-2	52	3	-2	16	72	-2	16	0	-2	16	0	-2	16	50	-2	25	-56	-2	25	0
-2	16	0	-2	16	0	-2	16	34	-2	64	9	-2	64	1	-2	64	1	-2	64	1	-2	64	1	-2	64	1	-2	64	1	-2	64	1	-2	64	3	-2	16	72	-2	16	0	-2	16	0	-2	16	0	-2	16	0	-2	16	0	-2	16	0	-2	16	0	-2	16	0	-2	16	0	-2	16	0	-2	16	0	-2	16	50	-2	52	8	-2	52	0	-2	52	0	-2	52	0	-2	52	0	-2	52	0	-2	52	0	-2	52	0	-2	52	2	-2	16	-56	-2	16	0	-2	16	0	-2	16	50	-2	25	-56	-2	25	0
-2	16	0	-2	16	0	-2	16	50	-2	64	8	-2	64	0	-2	64	0	-2	64	0	-2	64	0	-2	64	0	-2	64	0	-2	64	0	-2	64	2	-2	16	-56	-2	16	0	-2	16	0	-2	16	0	-2	16	0	-2	16	0	-2	16	0	-2	16	0	-2	16	0	-2	16	0	-2	16	0	-2	16	0	-2	16	50	-2	52	12	-2	52	4	-2	52	4	-2	52	4	-2	52	4	-2	52	4	-2	52	4	-2	52	4	-2	52	6	-2	16	-56	-2	16	0	-2	16	0	-2	16	50	-2	25	-56	-2	25	0
-2	16	0	-2	16	0	-2	16	50	-2	64	12	-2	64	4	-2	64	4	-2	64	4	-2	64	4	-2	64	4	-2	64	4	-2	64	4	-2	64	6	-2	16	-56	-2	16	0	-2	16	0	-2	16	0	-2	16	0	-2	16	0	-2	16	0	-2	16	0	-2	16	0	-2	16	0	-2	16	0	-2	16	0	-2	16	50	-2	73	9	-2	73	1	-2	73	1	-2	73	1	-2	73	1	-2	73	1	-2	73	1	-2	73	1	-2	73	3	-2	16	-56	-2	16	0	-2	16	0	-2	16	50	-2	25	-56	-2	25	0
-2	16	0	-2	16	0	-2	16	50	-2	73	9	-2	73	1	-2	73	1	-2	73	1	-2	73	1	-2	73	1	-2	73	1	-2	73	1	-2	73	3	-2	16	-56	-2	16	0	-2	16	0	-2	16	0	-2	16	0	-2	16	0	-2	16	0	-2	16	0	-2	16	0	-2	16	0	-2	16	0	-2	16	0	-2	16	50	-2	73	8	-2	73	0	-2	73	0	-2	73	0	3	6	3	-2	73	0	-2	73	0	-2	73	0	-2	73	2	-2	16	-56	-2	16	0	-2	16	0	-2	16	50	-2	25	-56	-2	25	0
-2	16	0	-2	16	0	-2	16	50	-2	73	8	-2	73	0	-2	73	0	-2	73	0	3	4	3	-2	73	0	-2	73	0	-2	73	0	-2	73	2	-2	16	-56	-2	16	0	-2	16	0	-2	16	0	-2	16	0	-2	16	0	-2	16	0	-2	16	0	-2	16	0	-2	16	0	-2	16	0	-2	16	0	-2	16	18	-2	73	12	-2	73	4	-2	73	4	-2	73	4	3	6	4	-2	73	4	-2	73	4	-2	73	4	-2	73	6	-2	16	-120	-2	16	0	-2	16	0	-2	16	50	-2	25	-56	-2	25	0
-2	16	0	-2	16	0	-2	16	50	-2	73	12	-2	73	4	-2	73	4	-2	73	4	3	4	4	-2	73	4	-2	73	4	-2	73	4	-2	73	6	-2	16	-56	-2	16	0	-2	16	0	-2	16	0	-2	16	0	-2	16	0	-2	16	0	-2	16	0	-2	16	32	-2	16	36	-2	16	100	-2	16	100	-2	16	116	-2	16	117	-2	16	-11	-2	16	-11	-2	16	-9	-2	19	-69	-2	16	-39	-2	16	-111	-2	16	-111	-2	16	-127	-2	16	-128	-2	16	0	-2	16	0	-2	16	50	-2	25	-56	-2	25	0
-2	16	0	-2	16	0	-2	16	18	-2	24	-3	-2	24	-11	-2	24	-11	-2	24	-9	-2	19	-5	-2	24	-3	-2	24	-11	-2	24	-11	-2	24	-9	-2	16	-120	-2	16	0	-2	16	0	-2	16	0	-2	16	0	-2	16	0	-2	16	0	-2	16	0	-2	16	34	-2	19	-7	-2	19	-75	-2	19	-11	-2	19	-11	-2	19	-11	-2	19	-11	-2	19	-11	-2	19	-27	-2	19	-10	-2	16	-20	-2	16	100	-2	16	100	-2	16	68	-2	16	64	-2	16	0	-2	16	0	-2	16	50	-2	25	-56	-2	25	0
-2	16	0	-2	16	0	-2	16	16	-2	16	17	-2	16	-111	-2	16	-111	-2	16	-77	-2	19	-6	-2	16	-39	-2	16	-111	-2	16	-111	-2	16	-127	-2	16	-128	-2	16	0	-2	16	0	-2	16	0	-2	16	0	-2	16	0	-2	16	0	-2	16	0	-2	16	50	-2	19	-22	-2	16	-39	-2	16	-111	-2	16	-77	-2	53	9	-2	53	1	-2	53	1	-2	53	1	-2	53	1	-2	53	1	-2	53	1	-2	53	1	-2	53	3	-2	16	72	-2	16	0	-2	16	0	-2	16	50	-2	25	-56	-2	25	0
-2	16	36	-2	16	100	-2	16	100	-2	16	100	-2	16	100	-2	16	100	-2	16	118	-2	19	-102	-2	16	-20	-2	16	100	-2	16	100	-2	16	100	-2	16	100	-2	16	100	-2	16	100	-2	16	100	-2	16	100	-2	16	100	-2	16	100	-2	16	100	-2	16	118	-2	19	-70	-2	16	-56	-2	16	0	-2	16	50	-2	53	8	-2	53	0	-2	53	0	-2	53	0	-2	53	0	-2	53	0	-2	53	0	-2	53	0	-2	53	2	-2	16	-56	-2	16	0	-2	16	0	-2	16	50	-2	25	-56	-2	25	0
-2	19	53	-2	19	-11	-2	19	-11	-2	19	-11	-2	19	-11	-2	19	-11	-2	19	-27	-2	19	-12	-2	19	117	-2	19	-11	-2	19	-11	-2	19	-11	-2	19	-11	-2	19	-11	-2	19	-11	-2	19	-11	-2	19	-11	-2	19	-11	-2	19	-11	-2	19	-11	-2	19	-59	-2	19	-14	-2	16	-56	-2	16	0	-2	16	50	-2	53	12	-2	53	4	-2	53	4	-2	53	4	-2	53	4	-2	53	4	-2	53	4	-2	53	4	-2	53	6	-2	16	-56	-2	16	0	-2	16	0	-2	16	50	-2	25	-56	-2	25	0
-2	16	17	-2	16	-111	-2	16	-111	-2	16	-111	-2	16	-111	-2	16	-111	-2	16	-111	-2	16	-111	-2	16	-111	-2	16	-111	-2	16	-111	-2	16	-111	-2	16	-111	-2	16	-111	-2	16	-111	-2	16	-111	-2	16	-111	-2	16	-111	-2	16	-111	-2	16	-111	-2	16	-77	-2	19	122	-2	16	-56	-2	16	0	-2	16	50	-2	73	9	-2	73	1	-2	73	1	-2	73	1	-2	73	1	-2	73	1	-2	73	1	-2	73	1	-2	73	3	-2	16	-56	-2	16	0	-2	16	0	-2	16	50	-2	25	-56	-2	25	0
-2	16	0	-2	16	0	-2	16	0	-2	16	0	-2	16	0	-2	16	0	-2	16	0	-2	16	0	-2	16	0	-2	16	0	-2	16	0	-2	16	0	-2	16	0	-2	16	0	-2	16	0	-2	16	0	-2	16	0	-2	16	0	-2	16	0	-2	16	0	-2	16	50	-2	19	-6	-2	16	-56	-2	16	0	-2	16	50	-2	73	8	-2	73	0	-2	73	0	-2	73	0	3	6	3	-2	73	0	-2	73	0	-2	73	0	-2	73	2	-2	16	-56	-2	16	0	-2	16	0	-2	16	50	-2	25	-56	-2	25	0
-2	16	0	-2	16	0	-2	16	0	-2	16	0	-2	16	0	-2	16	0	-2	16	0	-2	16	0	-2	16	0	-2	16	0	-2	16	0	-2	16	0	-2	16	0	-2	16	0	-2	16	0	-2	16	0	-2	16	0	-2	16	0	-2	16	0	-2	16	0	-2	16	50	-2	19	-6	-2	16	-56	-2	16	0	-2	16	50	-2	73	12	-2	73	4	-2	73	4	-2	73	4	3	6	4	-2	73	4	-2	73	4	-2	73	4	-2	73	6	-2	16	-56	-2	16	0	-2	16	0	-2	16	50	-2	25	-56	-2	25	0
-2	16	0	-2	16	0	-2	16	0	-2	16	0	-2	16	0	-2	16	0	-2	16	0	-2	16	0	-2	16	0	-2	16	0	-2	16	0	-2	16	0	-2	16	0	-2	16	0	-2	16	0	-2	16	0	-2	16	0	-2	16	0	-2	16	0	-2	16	0	-2	16	50	-2	19	-38	-2	16	-20	-2	16	100	-2	16	118	-2	24	-3	-2	24	-11	-2	24	-11	-2	24	-9	-2	19	-69	-2	24	-3	-2	24	-11	-2	24	-11	-2	24	-9	-2	16	-120	-2	16	0	-2	16	0	-2	16	50	-2	25	-56	-2	25	0
-2	16	0	-2	16	0	-2	16	0	-2	16	0	-2	16	0	-2	16	0	-2	16	0	-2	16	0	-2	16	0	-2	16	0	-2	16	0	-2	16	0	-2	16	0	-2	16	0	-2	16	0	-2	16	0	-2	16	0	-2	16	0	-2	16	0	-2	16	0	-2	16	18	-2	19	-4	-2	19	117	-2	19	-11	-2	19	-11	-2	19	-11	-2	19	-11	-2	19	-11	-2	19	-27	-2	19	-10	-2	16	-103	-2	16	-111	-2	16	-111	-2	16	-127	-2	16	-128	-2	16	0	-2	16	0	-2	16	50	-2	25	-56	-2	25	0
-2	16	0	-2	16	0	-2	16	0	-2	16	0	-2	16	0	-2	16	0	-2	16	0	-2	16	0	-2	16	0	-2	16	0	-2	16	0	-2	16	0	-2	16	0	-2	16	0	-2	16	0	-2	16	0	-2	16	0	-2	16	0	-2	16	0	-2	16	0	-2	16	16	-2	16	17	-2	16	-111	-2	16	-111	-2	16	-111	-2	16	-111	-2	16	-111	-2	16	-111	-2	16	-111	-2	16	-127	-2	16	-128	-2	16	0	-2	16	0	-2	16	0	-2	16	0	-2	16	0	-2	16	0	-2	16	50	-2	25	-56	-2	25	0
-2	16	0	-2	16	0	-2	16	0	-2	16	0	-2	16	0	-2	16	0	-2	16	0	-2	16	0	-2	16	0	-2	16	0	-2	16	0	-2	16	0	-2	16	0	-2	16	0	-2	16	0	-2	16	0	-2	16	0	-2	16	0	-2	16	0	-2	16	0	-2	16	0	-2	16	0	-2	16	0	-2	16	0	-2	16	0	-2	16	0	-2	16	0	-2	16	0	-2	16	0	-2	16	0	-2	16	0	-2	16	0	-2	16	0	-2	16	0	-2	16	0	-2	16	0	-2	16	0	-2	16	50	-2	25	-56	-2	25	0
-2	16	0	-2	16	0	-2	16	0	-2	16	0	-2	16	0	-2	16	0	-2	16	0	-2	16	0	-2	16	0	-2	16	0	-2	16	0	-2	16	0	-2	16	0	-2	16	0	-2	16	0	-2	16	0	-2	16	0	-2	16	0	-2	16	0	-2	16	0	-2	16	0	-2	16	0	-2	16	0	-2	16	0	-2	16	0	-2	16	0	-2	16	0	-2	16	0	-2	16	0	-2	16	0	-2	16	0	-2	16	0	-2	16	0	-2	16	0	-2	16	0	-2	16	0	-2	16	0	-2	16	50	-2	25	-56	-2	25	0
-2	16	0	-2	16	0	-2	16	0	-2	16	0	-2	16	0	-2	16	0	-2	16	0	-2	16	0	-2	16	0	-2	16	0	-2	16	0	-2	16	0	-2	16	0	-2	16	0	-2	16	0	-2	16	0	-2	16	0	-2	16	0	-2	16	0	-2	16	0	-2	16	0	-2	16	0	-2	16	0	-2	16	0	-2	16	0	-2	16	0	-2	16	0	-2	16	0	-2	16	0	-2	16	0	-2	16	0	-2	16	0	-2	16	0	-2	16	0	-2	16	0	-2	16	0	-2	16	0	-2	16	50	-2	25	-56	-2	25	0
-2	16	0	-2	16	0	-2	16	0	-2	16	0	-2	16	0	-2	16	0	-2	16	0	-2	16	0	-2	16	0	-2	16	0	-2	16	0	-2	16	0	-2	16	0	-2	16	0	-2	16	0	-2	16	0	-2	16	0	-2	16	0	-2	16	0	-2	16	0	-2	16	0	-2	16	0	-2	16	0	-2	16	0	-2	16	0	-2	16	0	-2	16	0	-2	16	0	-2	16	0	-2	16	0	-2	16	0	-2	16	0	-2	16	0	-2	16	0	-2	16	0	-2	16	0	-2	16	0	-2	16	50	-2	25	-56	-2	25	0
-2	16	0	-2	16	0	-2	16	0	-2	16	0	-2	16	0	-2	16	0	-2	16	0	-2	16	0	-2	16	0	-2	16	0	-2	16	0	-2	16	0	-2	16	0	-2	16	0	-2	16	0	-2	16	0	-2	16	0	-2	16	0	-2	16	0	-2	16	0	-2	16	0	-2	16	0	-2	16	0	-2	16	0	-2	16	0	-2	16	0	-2	16	0	-2	16	0	-2	16	0	-2	16	0	-2	16	0	-2	16	0	-2	16	0	-2	16	0	-2	16	0	-2	16	0	-2	16	0	-2	16	50	-2	25	-56	-2	25	0
-2	16	0	-2	16	0	-2	16	0	-2	16	0	-2	16	0	-2	16	0	-2	16	0	-2	16	0	-2	16	0	-2	16	0	-2	16	0	-2	16	0	-2	16	0	-2	16	0	-2	16	0	-2	16	0	-2	16	0	-2	16	0	-2	16	0	-2	16	0	-2	16	0	-2	16	0	-2	16	0	-2	16	0	-2	16	0	-2	16	0	-2	16	0	-2	16	0	-2	16	0	-2	16	0	-2	16	0	-2	16	0	-2	16	0	-2	16	0	-2	16	0	-2	16	0	-2	16	0	-2	16	50	-2	25	-56	-2	25	0
-2	16	0	-2	16	0	-2	16	0	-2	16	0	-2	16	0	-2	16	0	-2	16	0	-2	16	0	-2	16	0	-2	16	0	-2	16	0	-2	16	0	-2	16	0	-2	16	0	-2	16	0	-2	16	0	-2	16	0	-2	16	0	-2	16	0	-2	16	0	-2	16	0	-2	16	0	-2	16	0	-2	16	0	-2	16	0	-2	16	0	-2	16	0	-2	16	0	-2	16	0	-2	16	0	-2	16	0	-2	16	0	-2	16	0	-2	16	0	-2	16	0	-2	16	0	-2	16	0	-2	16	50	-2	25	-56	-2	25	0
-2	16	0	-2	16	0	-2	16	0	-2	16	0	-2	16	0	-2	16	0	-2	16	0	-2	16	0	-2	16	0	-2	16	0	-2	16	0	-2	16	0	-2	16	0	-2	16	0	-2	16	0	-2	16	0	-2	16	0	-2	16	0	-2	16	0	-2	16	0	-2	16	0	-2	16	0	-2	16	0	-2	16	0	-2	16	0	-2	16	0	-2	16	0	-2	16	0	-2	16	0	-2	16	0	-2	16	0	-2	16	0	-2	16	0	-2	16	0	-2	16	0	-2	16	0	-2	16	0	-2	16	50	-2	25	-56	-2	25	0
-2	16	0	-2	16	0	-2	16	0	-2	16	0	-2	16	0	-2	16	0	-2	16	0	-2	16	0	-2	16	0	-2	16	0	-2	16	0	-2	16	0	-2	16	0	-2	16	0	-2	16	0	-2	16	0	-2	16	0	-2	16	0	-2	16	0	-2	16	0	-2	16	0	-2	16	0	-2	16	0	-2	16	0	-2	16	0	-2	16	0	-2	16	0	-2	16	0	-2	16	0	-2	16	0	-2	16	0	-2	16	0	-2	16	0	-2	16	0	-2	16	0	-2	16	0	-2	16	0	-2	16	18	-2	25	-120	-2	25	0
