-2	16	0	-2	16	0	-2	16	0	-2	16	0	-2	16	0	-2	16	0	-2	16	0	-2	16	0	-2	16	0	-2	16	0	-2	16	0	-2	16	0	-2	16	0	-2	16	0	-2	16	0	-2	16	0	-2	16	0	-2	16	0	-2	16	0	-2	16	0	-2	16	0	-2	16	0	-2	16	0	-2	16	0	-2	16	0	-2	16	0	-2	16	0	-2	16	0	-2	16	0	-2	16	34	-2	8	72	-2	8	0	-2	8	0	-2	8	0	-2	8	0	-2	8	0	-2	8	0	-2	8	0	-2	8	0	-2	8	0
-2	16	0	-2	16	32	-2	16	36	-2	16	100	-2	16	100	-2	16	100	-2	16	100	-2	16	100	-2	16	100	-2	16	100	-2	16	100	-2	16	100	-2	16	100	-2	16	68	-2	16	64	-2	16	0	-2	16	0	-2	16	0	-2	16	0	-2	16	0	-2	16	0	-2	16	0	-2	16	0	-2	16	0	-2	16	0	-2	16	0	-2	16	0	-2	16	0	-2	16	0	-2	16	50	-2	8	-56	-2	8	0	-2	8	0	-2	8	0	-2	8	0	-2	8	0	-2	8	0	-2	8	0	-2	8	0	-2	8	0
-2	16	0	-2	16	34	-2	76	9	-2	76	1	-2	76	1	-2	76	1	-2	76	1	-2	76	1	-2	76	1	-2	76	1	-2	76	1	-2	76	1	-2	76	1	-2	76	3	-2	16	72	-2	16	0	-2	16	0	-2	16	0	-2	16	0	-2	16	0	-2	16	0	-2	16	0	-2	16	0	-2	16	0	-2	16	0	-2	16	0	-2	16	0	-2	16	0	-2	16	0	-2	16	50	-2	8	-56	-2	8	0	-2	8	0	-2	8	0	-2	8	0	-2	8	0	-2	8	0	-2	8	0	-2	8	0	-2	8	0
-2	16	0	-2	16	50	-2	76	8	-2	16	-39	-2	16	-77	-2	76	0	-2	76	0	-2	16	-39	-2	16	-77	-2	76	0	-2	76	0	-2	16	-39	-2	16	-77	-2	76	2	-2	16	-56	-2	16	0	-2	16	0	-2	16	0	-2	16	0	-2	16	0	-2	16	0	-2	16	0	-2	16	0	-2	16	0	-2	16	0	-2	16	0	-2	16	0	-2	16	0	-2	16	0	-2	16	50	-2	8	-56	-2	8	0	-2	8	0	-2	8	0	-2	8	0	-2	8	0	-2	8	0	-2	8	0	-2	8	0	-2	8	0
-2	16	0	-2	16	50	-2	76	8	-2	16	-20	-2	16	118	-2	76	0	-2	76	0	-2	16	-20	-2	16	118	-2	76	0	-2	76	0	-2	16	-20	-2	16	118	-2	76	2	-2	16	-56	-2	16	0	-2	16	0	-2	16	0	-2	16	0	-2	16	0	-2	16	0	-2	16	0	-2	16	0	-2	16	0	-2	16	0	-2	16	0	-2	16	0	-2	16	0	-2	16	0	-2	16	50	-2	8	-56	-2	8	0	-2	8	0	-2	8	0	-2	8	0	-2	8	0	-2	8	0	-2	8	0	-2	8	0	-2	8	0
-2	16	0	-2	16	18	-2	76	12	-2	17	125	-2	17	-9	-2	76	4	-2	76	4	-2	17	-3	-2	17	-9	-2	76	4	-2	76	4	-2	17	-3	-2	17	-9	-2	76	6	-2	16	-120	-2	16	0	-2	16	0	-2	16	0	-2	16	0	-2	16	0	-2	16	0	-2	16	0	-2	16	0	-2	16	0	-2	16	0	-2	16	0	-2	16	0	-2	16	0	-2	16	0	-2	16	50	-2	8	-56	-2	8	0	-2	8	0	-2	8	0	-2	8	0	-2	8	0	-2	8	0	-2	8	0	-2	8	0	-2	8	0
-2	16	0	-2	16	16	-2	16	17	-2	16	-111	-2	16	-111	-2	16	-111	-2	16	-111	-2	16	-111	-2	16	-111	-2	16	-111	-2	16	-111	-2	16	-111	-2	16	-111	-2	16	-127	-2	16	-128	-2	16	0	-2	16	0	-2	16	0	-2	16	0	-2	16	0	-2	16	0	-2	16	0	-2	16	0	-2	16	0	-2	16	0	-2	16	0	-2	16	0	-2	16	0	-2	16	0	-2	16	50	-2	8	-56	-2	8	0	-2	8	0	-2	8	0	-2	8	0	-2	8	0	-2	8	0	-2	8	0	-2	8	0	-2	8	0
-2	16	32	-2	16	36	-2	16	100	-2	16	100	-2	16	100	-2	16	100	-2	16	100	-2	16	100	-2	16	100	-2	16	100	-2	16	100	-2	16	68	-2	16	64	-2	16	0	-2	16	0	-2	16	0	-2	16	0	-2	16	0	-2	16	0	-2	16	0	-2	16	0	-2	16	0	-2	16	0	-2	16	0	-2	16	0	-2	16	0	-2	16	0	-2	16	0	-2	16	0	-2	16	50	-2	8	-56	-2	8	0	-2	8	0	-2	8	0	-2	8	0	-2	8	0	-2	8	0	-2	8	0	-2	8	0	-2	8	0
-2	16	34	-2	17	-7	-2	17	-75	-2	17	-11	-2	17	-11	-2	17	-11	-2	17	-11	-2	17	-11	-2	17	-11	-2	17	-11	-2	17	-43	-2	17	-13	-2	16	72	-2	16	0	-2	16	0	-2	16	0	-2	16	0	-2	16	0	-2	16	0	-2	16	0	-2	16	0	-2	16	0	-2	16	0	-2	16	0	-2	16	0	-2	16	0	-2	16	0	-2	16	0	-2	16	0	-2	16	50	-2	8	-56	-2	8	0	-2	8	0	-2	8	0	-2	8	0	-2	8	0	-2	8	0	-2	8	0	-2	8	0	-2	8	0
-2	16	50	-2	17	-22	-2	16	-39	-2	16	-111	-2	16	-111	-2	16	-111	-2	16	-111	-2	16	-111	-2	16	-111	-2	16	-111	-2	16	-77	-2	17	122	-2	16	-56	-2	16	0	-2	16	0	-2	16	0	-2	16	0	-2	16	0	-2	16	0	-2	16	0	-2	16	0	-2	16	0	-2	16	0	-2	16	0	-2	16	0	-2	16	0	-2	16	0	-2	16	0	-2	16	0	-2	16	50	-2	8	-20	-2	8	100	-2	8	100	-2	8	100	-2	8	100	-2	8	100	-2	8	100	-2	8	100	-2	8	100	-2	8	68
-2	16	50	-2	17	-6	-2	16	-56	-2	16	0	-2	16	0	-2	16	0	-2	16	0	-2	16	0	-2	16	0	-2	16	0	-2	16	50	-2	17	-6	-2	16	-56	-2	16	0	-2	16	0	-2	16	0	-2	16	0	-2	16	0	-2	16	0	-2	16	0	-2	16	0	-2	16	0	-2	16	0	-2	16	0	-2	16	0	-2	16	0	-2	16	0	-2	16	0	-2	16	0	-2	16	50	-2	17	-3	-2	17	-11	-2	17	-11	-2	17	-11	-2	17	-11	-2	17	-11	-2	17	-11	-2	17	-11	-2	17	-11	-2	17	-59
-2	16	50	-2	17	-6	-2	16	-56	-2	16	0	-2	16	0	-2	16	0	-2	16	0	-2	16	0	-2	16	0	-2	16	0	-2	16	50	-2	17	-6	-2	16	-56	-2	16	0	-2	16	0	-2	16	0	-2	16	0	-2	16	0	-2	16	0	-2	16	0	-2	16	0	-2	16	0	-2	16	0	-2	16	0	-2	16	0	-2	16	0	-2	16	0	-2	16	0	-2	16	0	-2	16	50	0	4	2	0	4	2	0	4	2	0	4	2	0	4	2	0	4	2	0	4	2	0	4	2	0	4	2	0	4	2
-2	16	50	-2	17	-38	-2	16	-20	-2	16	100	-2	16	100	-2	16	100	-2	16	100	-2	16	100	-2	16	100	-2	16	100	-2	16	118	-2	17	-70	-2	16	-56	-2	16	0	-2	16	0	-2	16	0	-2	16	0	-2	16	0	-2	16	0	-2	16	0	-2	16	0	-2	16	0	-2	16	0	-2	16	0	-2	16	0	-2	16	0	-2	16	0	-2	16	0	-2	16	0	-2	16	50	0	4	2	0	4	2	0	4	2	0	4	2	0	4	2	0	4	2	0	4	2	0	4	2	0	4	2	0	4	2
-2	16	18	-2	17	-4	-2	17	117	-2	17	-11	-2	17	-11	-2	17	-11	-2	17	-11	-2	17	-11	-2	17	-11	-2	17	-11	-2	17	-27	-2	17	-10	-2	16	-120	-2	16	0	-2	16	0	-2	16	0	-2	16	0	-2	16	0	-2	16	0	-2	16	0	-2	16	0	-2	16	0	-2	16	0	-2	16	0	-2	16	0	-2	16	0	-2	16	0	-2	16	0	-2	16	0	-2	16	50	-2	17	-3	-2	17	-11	-2	17	-11	-2	17	-11	-2	17	-11	-2	17	-11	-2	17	-11	-2	17	-11	-2	17	-11	-2	17	-59
-2	16	16	-2	16	17	-2	16	-111	-2	16	-111	-2	16	-111	-2	16	-111	-2	16	-111	-2	16	-111	-2	16	-111	-2	16	-111	-2	16	-111	-2	16	-127	-2	16	-128	-2	16	0	-2	16	0	-2	16	0	-2	16	0	-2	16	0	-2	16	0	-2	16	0	-2	16	0	-2	16	0	-2	16	0	-2	16	0	-2	16	0	-2	16	0	-2	16	0	-2	16	0	-2	16	0	-2	16	50	-2	8	-39	-2	8	-111	-2	8	-111	-2	8	-111	-2	8	-111	-2	8	-111	-2	8	-111	-2	8	-111	-2	8	-111	-2	8	-127
-2	16	0	-2	16	0	-2	16	0	-2	16	0	-2	16	0	-2	16	0	-2	16	0	-2	16	0	-2	16	0	-2	16	0	-2	16	0	-2	16	0	-2	16	0	-2	16	0	-2	16	0	-2	16	0	-2	16	0	-2	16	0	-2	16	0	-2	16	0	-2	16	0	-2	16	0	-2	16	0	-2	16	0	-2	16	0	-2	16	0	-2	16	0	-2	16	0	-2	16	0	-2	16	50	-2	8	-56	-2	8	0	-2	8	0	-2	8	0	-2	8	0	-2	8	0	-2	8	0	-2	8	0	-2	8	0	-2	8	0
-2	16	0	-2	16	0	-2	16	0	-2	16	0	-2	16	0	-2	16	0	-2	16	0	-2	16	0	-2	16	0	-2	16	0	-2	16	0	-2	16	0	-2	16	0	-2	16	0	-2	16	0	-2	16	0	-2	16	0	-2	16	0	-2	16	0	-2	16	0	-2	16	0	-2	16	0	-2	16	0	-2	16	0	-2	16	0	-2	16	0	-2	16	0	-2	16	0	-2	16	0	-2	16	50	-2	8	-56	-2	8	0	-2	8	0	-2	8	0	-2	8	0	-2	8	0	-2	8	0	-2	8	0	-2	8	0	-2	8	0
-2	16	0	-2	16	0	-2	16	0	-2	16	0	-2	16	0	-2	16	0	-2	16	0	-2	16	0	-2	16	0	-2	16	0	-2	16	0	-2	16	0	-2	16	0	-2	16	0	-2	16	0	-2	16	0	-2	16	0	-2	16	0	-2	16	0	-2	16	0	-2	16	0	-2	16	0	-2	16	0	-2	16	0	-2	16	0	-2	16	0	-2	16	0	-2	16	0	-2	16	0	-2	16	50	-2	8	-56	-2	8	0	-2	8	0	-2	8	0	-2	8	0	-2	8	0	-2	8	0	-2	8	0	-2	8	0	-2	8	0
-2	16	0	-2	16	0	-2	16	0	-2	16	0	-2	16	0	-2	16	0	-2	16	0	-2	16	0	-2	16	0	-2	16	0	-2	16	0	-2	16	0	-2	16	0	-2	16	0	-2	16	0	-2	16	0	-2	16	0	-2	16	0	-2	16	0	-2	16	0	-2	16	0	-2	16	0	-2	16	0	-2	16	0	-2	16	0	-2	16	0	-2	16	0	-2	16	0	-2	16	0	-2	16	50	-2	8	-56	-2	8	0	-2	8	0	-2	8	0	-2	8	0	-2	8	0	-2	8	0	-2	8	0	-2	8	0	-2	8	0
-2	16	0	-2	16	0	-2	16	0	-2	16	0	-2	16	0	-2	16	0	-2	16	0	-2	16	0	-2	16	0	-2	16	0	-2	16	0	-2	16	0	-2	16	0	-2	16	0	-2	16	0	-2	16	0	-2	16	0	-2	16	0	-2	16	0	-2	16	0	-2	16	0	-2	16	0	-2	16	0	-2	16	0	-2	16	0	-2	16	0	-2	16	0	-2	16	0	-2	16	0	-2	16	50	-2	8	-56	-2	8	0	-2	8	0	-2	8	0	-2	8	0	-2	8	0	-2	8	0	-2	8	0	-2	8	0	-2	8	0
-2	16	0	-2	16	0	-2	16	0	-2	16	0	-2	16	0	-2	16	0	-2	16	0	-2	16	0	-2	16	0	-2	16	0	-2	16	0	-2	16	0	-2	16	0	-2	16	0	-2	16	0	-2	16	0	-2	16	0	-2	16	0	-2	16	0	-2	16	0	-2	16	0	-2	16	0	-2	16	0	-2	16	0	-2	16	0	-2	16	0	-2	16	0	-2	16	0	-2	16	0	-2	16	50	-2	8	-56	-2	8	0	-2	8	0	-2	8	0	-2	8	0	-2	8	0	-2	8	0	-2	8	0	-2	8	0	-2	8	0
-2	16	0	-2	16	0	-2	16	0	-2	16	0	-2	16	0	-2	16	0	-2	16	0	-2	16	0	-2	16	0	-2	16	0	-2	16	0	-2	16	0	-2	16	0	-2	16	0	-2	16	0	-2	16	0	-2	16	0	-2	16	0	-2	16	0	-2	16	0	-2	16	0	-2	16	0	-2	16	0	-2	16	0	-2	16	0	-2	16	0	-2	16	0	-2	16	0	-2	16	0	-2	16	50	-2	8	-56	-2	8	0	-2	8	0	-2	8	0	-2	8	0	-2	8	0	-2	8	0	-2	8	0	-2	8	0	-2	8	0
-2	16	0	-2	16	0	-2	16	0	-2	16	0	-2	16	0	-2	16	0	-2	16	0	-2	16	0	-2	16	0	-2	16	0	-2	16	0	-2	16	0	-2	16	0	-2	16	0	-2	16	0	-2	16	0	-2	16	0	-2	16	0	-2	16	0	-2	16	0	-2	16	0	-2	16	0	-2	16	0	-2	16	0	-2	16	0	-2	16	0	-2	16	0	-2	16	0	-2	16	0	-2	16	50	-2	8	-56	-2	8	0	-2	8	0	-2	8	0	-2	8	0	-2	8	0	-2	8	0	-2	8	0	-2	8	0	-2	8	0
-2	16	0	-2	16	0	-2	16	0	-2	16	0	-2	16	0	-2	16	0	-2	16	0	-2	16	0	-2	16	0	-2	16	0	-2	16	0	-2	16	0	-2	16	0	-2	16	0	-2	16	0	-2	16	0	-2	16	0	-2	16	0	-2	16	0	-2	16	0	-2	16	0	-2	16	0	-2	16	0	-2	16	0	-2	16	0	-2	16	0	-2	16	0	-2	16	0	-2	16	0	-2	16	50	-2	8	-56	-2	8	0	-2	8	0	-2	8	0	-2	8	0	-2	8	0	-2	8	0	-2	8	0	-2	8	0	-2	8	0
-2	16	0	-2	16	0	-2	16	0	-2	16	0	-2	16	0	-2	16	0	-2	16	0	-2	16	0	-2	16	0	-2	16	0	-2	16	0	-2	16	0	-2	16	0	-2	16	0	-2	16	0	-2	16	0	-2	16	0	-2	16	0	-2	16	0	-2	16	0	-2	16	0	-2	16	0	-2	16	0	-2	16	0	-2	16	0	-2	16	0	-2	16	0	-2	16	0	-2	16	0	-2	16	50	-2	8	-56	-2	8	0	-2	8	0	-2	8	0	-2	8	0	-2	8	0	-2	8	0	-2	8	0	-2	8	0	-2	8	0
-2	16	0	-2	16	0	-2	16	0	-2	16	0	-2	16	0	-2	16	0	-2	16	0	-2	16	0	-2	16	0	-2	16	0	-2	16	0	-2	16	0	-2	16	0	-2	16	0	-2	16	0	-2	16	0	-2	16	0	-2	16	0	-2	16	0	-2	16	0	-2	16	0	-2	16	0	-2	16	0	-2	16	0	-2	16	0	-2	16	0	-2	16	0	-2	16	0	-2	16	0	-2	16	50	-2	8	-56	-2	8	0	-2	8	0	-2	8	0	-2	8	0	-2	8	0	-2	8	0	-2	8	0	-2	8	0	-2	8	0
-2	16	0	-2	16	0	-2	16	0	-2	16	0	-2	16	0	-2	16	0	-2	16	0	-2	16	0	-2	16	0	-2	16	0	-2	16	0	-2	16	0	-2	16	0	-2	16	0	-2	16	0	-2	16	0	-2	16	0	-2	16	0	-2	16	0	-2	16	0	-2	16	0	-2	16	0	-2	16	0	-2	16	0	-2	16	0	-2	16	0	-2	16	0	-2	16	0	-2	16	0	-2	16	50	-2	8	-56	-2	8	0	-2	8	0	-2	8	0	-2	8	0	-2	8	0	-2	8	0	-2	8	0	-2	8	0	-2	8	0
-2	16	0	-2	16	0	-2	16	0	-2	16	0	-2	16	0	-2	16	0	-2	16	0	-2	16	0	-2	16	0	-2	16	0	-2	16	0	-2	16	0	-2	16	0	-2	16	0	-2	16	0	-2	16	0	-2	16	0	-2	16	0	-2	16	0	-2	16	0	-2	16	0	-2	16	0	-2	16	0	-2	16	0	-2	16	0	-2	16	0	-2	16	0	-2	16	0	-2	16	0	-2	16	50	-2	8	-56	-2	8	0	-2	8	0	-2	8	0	-2	8	0	-2	8	0	-2	8	0	-2	8	0	-2	8	0	-2	8	0
-2	16	0	-2	16	0	-2	16	0	-2	16	0	-2	16	0	-2	16	0	-2	16	0	-2	16	0	-2	16	0	-2	16	0	-2	16	0	-2	16	0	-2	16	0	-2	16	0	-2	16	0	-2	16	0	-2	16	0	-2	16	0	-2	16	0	-2	16	0	-2	16	0	-2	16	0	-2	16	0	-2	16	0	-2	16	0	-2	16	0	-2	16	0	-2	16	0	-2	16	0	-2	16	50	-2	8	-56	-2	8	0	-2	8	0	-2	8	0	-2	8	0	-2	8	0	-2	8	0	-2	8	0	-2	8	0	-2	8	0
-2	16	0	-2	16	0	-2	16	0	-2	16	0	-2	16	0	-2	16	0	-2	16	0	-2	16	0	-2	16	0	-2	16	0	-2	16	0	-2	16	0	-2	16	0	-2	16	0	-2	16	0	-2	16	0	-2	16	0	-2	16	0	-2	16	0	-2	16	0	-2	16	0	-2	16	0	-2	16	0	-2	16	0	-2	16	0	-2	16	0	-2	16	0	-2	16	0	-2	16	0	-2	16	18	-2	8	-120	-2	8	0	-2	8	0	-2	8	0	-2	8	0	-2	8	0	-2	8	0	-2	8	0	-2	8	0	-2	8	0
