1	5	3	1	5	3	1	5	3	1	5	3	1	5	3	1	5	3	1	5	3	1	5	3	1	5	3	1	5	3	1	5	3	1	5	3	1	5	3	1	5	3	1	5	3	1	5	3	1	5	3	1	5	3	1	5	3	1	5	3
1	3	3	1	3	3	1	3	3	1	3	3	1	3	3	1	3	3	1	3	3	1	3	3	1	3	3	1	3	3	1	3	3	1	3	3	1	3	3	1	3	3	1	3	3	1	3	3	1	3	3	1	3	3	1	3	3	1	3	3
1	4	3	1	4	3	1	4	3	1	4	3	1	4	3	1	4	3	1	4	3	1	4	3	1	4	3	1	4	3	1	4	3	1	4	3	1	4	3	1	4	3	1	4	3	1	4	3	1	4	3	1	4	3	1	4	3	1	4	3
1	5	3	1	5	3	1	5	3	1	5	3	1	5	3	1	5	3	1	5	3	1	5	3	1	5	3	1	5	3	1	5	3	1	5	3	1	5	3	1	5	3	1	5	3	1	5	3	1	5	3	1	5	3	1	5	3	1	5	3
1	3	3	1	3	3	1	3	3	1	3	3	1	3	3	1	3	3	1	3	3	1	3	3	1	3	3	1	3	3	1	3	3	1	3	3	1	3	3	1	3	3	1	3	3	1	3	3	1	3	3	1	3	3	1	3	3	1	3	3
1	4	3	1	4	3	1	4	3	1	4	3	1	4	3	1	4	3	1	4	3	1	4	3	1	4	3	1	4	3	1	4	3	1	4	3	1	4	3	1	4	3	1	4	3	1	4	3	1	4	3	1	4	3	1	4	3	1	4	3
1	5	3	1	5	3	1	5	3	1	5	3	1	5	3	1	5	3	1	5	3	1	5	3	1	5	3	1	5	3	1	5	3	1	5	3	1	5	3	1	5	3	1	5	3	1	5	3	1	5	3	1	5	3	1	5	3	1	5	3
1	3	3	1	3	3	1	3	3	1	3	3	1	3	3	1	3	3	1	3	3	1	3	3	1	3	3	1	3	3	1	3	3	1	3	3	1	3	3	1	3	3	1	3	3	1	3	3	1	3	3	1	3	3	1	3	3	1	3	3
1	4	3	1	4	3	1	4	3	1	4	3	1	4	3	1	4	3	1	4	3	1	4	3	1	4	3	1	4	3	1	4	3	1	4	3	1	4	3	1	4	3	1	4	3	1	4	3	1	4	3	1	4	3	1	4	3	1	4	3
1	5	3	1	5	3	1	5	3	1	5	3	1	5	3	1	5	3	1	5	3	1	5	3	1	5	3	1	5	3	1	5	3	1	5	3	1	5	3	1	5	3	1	5	3	1	5	3	1	5	3	1	5	3	1	5	3	1	5	3
1	3	3	1	3	3	1	3	3	1	3	3	1	3	3	1	3	3	1	3	3	1	3	3	1	3	3	1	3	3	1	3	3	1	3	3	1	3	3	1	3	3	1	3	3	1	3	3	1	3	3	1	3	3	1	3	3	1	3	3
1	4	3	1	4	3	1	4	3	1	4	3	1	4	3	1	4	3	1	4	3	1	4	3	1	4	3	1	3	3	1	4	3	1	4	3	1	4	3	1	4	3	1	4	3	1	4	3	1	4	3	1	4	3	1	4	3	1	4	3
1	5	3	1	5	3	1	5	3	1	5	3	1	5	3	1	5	3	1	5	3	1	5	3	1	5	3	1	3	3	1	3	3	1	5	3	1	5	3	1	5	3	1	5	3	1	5	3	1	5	3	1	5	3	1	5	3	1	5	3
1	3	3	1	3	3	1	3	3	1	3	3	1	3	3	1	3	3	1	3	3	1	3	3	1	3	3	1	3	3	1	3	3	1	3	3	1	3	3	1	3	3	1	3	3	1	3	3	1	3	3	1	3	3	1	3	3	1	3	3
1	4	3	1	4	3	1	4	3	1	4	3	1	4	3	1	4	3	1	4	3	1	4	3	1	4	3	1	3	3	1	3	3	1	4	3	1	4	3	1	4	3	1	4	3	1	4	3	1	4	3	1	4	3	1	4	3	1	4	3
