-2	38	0	-2	38	0	-2	38	0	-2	38	0	-2	38	0	-2	38	0	-2	38	0	-2	38	0	-2	38	0	-2	38	0	-2	38	0	-2	38	0	-2	38	0	-2	38	0	-2	38	0	-2	38	0	-2	38	0	-2	38	0	-2	38	0	-2	38	0	-2	38	0	-2	38	0	-2	38	0	-2	38	0	-2	38	0	-2	38	0	-2	38	0	-2	38	0	-2	38	0	-2	38	0	-2	38	0	-2	38	0	-2	38	0	-2	38	0	-2	38	0	-2	38	0	-2	38	0	-2	38	0	-2	38	0	-2	38	0
-2	38	0	-2	38	0	-2	38	0	-2	38	0	-2	38	0	-2	38	0	-2	38	0	-2	38	0	-2	38	0	-2	38	0	-2	38	0	-2	38	0	-2	38	0	-2	38	0	-2	38	0	-2	38	0	-2	38	0	-2	38	0	-2	38	0	-2	38	0	-2	38	0	-2	38	0	-2	38	0	-2	38	0	-2	38	0	-2	38	0	-2	38	0	-2	38	0	-2	38	0	-2	38	0	-2	38	0	-2	38	0	-2	38	0	-2	38	0	-2	38	0	-2	38	0	-2	38	0	-2	38	0	-2	38	0	-2	38	0
-2	38	0	-2	38	0	-2	38	0	-2	38	0	-2	38	0	-2	38	0	-2	38	0	-2	38	0	-2	38	0	-2	38	0	-2	38	0	-2	38	0	-2	38	0	-2	38	0	-2	38	0	-2	38	0	-2	38	0	-2	38	0	-2	38	0	-2	38	0	-2	38	0	-2	38	0	-2	38	0	-2	38	0	-2	38	0	-2	38	0	-2	38	0	-2	38	0	-2	38	0	-2	38	0	-2	38	0	-2	38	0	-2	38	0	-2	38	0	-2	38	0	-2	38	0	-2	38	0	-2	38	0	-2	38	0	-2	38	0
-2	38	0	-2	38	0	-2	38	0	-2	38	0	-2	38	0	-2	38	0	-2	38	0	-2	38	0	-2	38	0	-2	38	0	-2	38	0	-2	38	0	-2	38	0	-2	38	0	-2	38	0	-2	38	0	-2	38	0	-2	38	0	-2	38	0	-2	38	0	-2	38	0	-2	38	0	-2	38	0	-2	38	0	-2	38	0	-2	38	0	-2	38	0	-2	38	0	-2	38	0	-2	38	0	-2	38	0	-2	38	0	-2	38	0	-2	38	0	-2	38	0	-2	38	0	-2	38	0	-2	38	0	-2	38	0	-2	38	0
-2	38	0	-2	38	0	-2	38	0	-2	38	0	-2	38	0	-2	38	0	-2	38	0	-2	38	0	-2	38	0	-2	38	0	-2	38	0	-2	38	0	-2	38	0	-2	38	0	-2	38	0	-2	38	0	-2	38	0	-2	38	0	-2	38	0	-2	38	0	-2	38	0	-2	38	0	-2	38	0	-2	38	0	-2	38	0	-2	38	0	-2	38	0	-2	38	0	-2	38	0	-2	38	0	-2	38	0	-2	38	0	-2	38	0	-2	38	0	-2	38	0	-2	38	0	-2	38	0	-2	38	0	-2	38	0	-2	38	0
-2	38	0	-2	38	0	-2	38	0	-2	38	0	-2	38	0	-2	38	0	-2	38	0	-2	38	0	-2	38	0	-2	38	0	-2	38	0	-2	38	0	-2	38	0	-2	38	0	-2	38	0	-2	38	0	-2	38	0	-2	38	0	-2	38	0	-2	38	0	-2	38	0	-2	38	0	-2	38	0	-2	38	0	-2	38	0	-2	38	0	-2	38	0	-2	38	0	-2	38	0	-2	38	0	-2	38	0	-2	38	0	-2	38	0	-2	38	0	-2	38	0	-2	38	0	-2	38	0	-2	38	0	-2	38	0	-2	38	0
-2	38	0	-2	38	0	-2	38	0	-2	38	0	-2	38	0	-2	38	0	-2	38	0	-2	38	0	-2	38	0	-2	38	0	-2	38	0	-2	38	0	-2	38	0	-2	38	0	-2	38	0	-2	38	0	-2	38	0	-2	38	0	-2	38	0	-2	38	0	-2	38	0	-2	38	0	-2	38	0	-2	38	0	-2	38	0	-2	38	0	-2	38	0	-2	38	0	-2	38	0	-2	38	0	-2	38	0	-2	38	0	-2	38	0	-2	38	0	-2	38	0	-2	38	0	-2	38	0	-2	38	0	-2	38	0	-2	38	0
-2	38	0	-2	38	0	-2	38	0	-2	38	0	-2	38	0	-2	38	0	-2	38	0	-2	38	0	-2	38	0	-2	38	0	-2	38	0	-2	38	0	-2	38	0	-2	38	0	-2	38	0	-2	38	0	-2	38	0	-2	38	0	-2	38	0	-2	38	0	-2	38	0	-2	38	0	-2	38	0	-2	38	0	-2	38	0	-2	38	0	-2	38	0	-2	38	0	-2	38	0	-2	38	0	-2	38	0	-2	38	0	-2	38	0	-2	38	0	-2	38	0	-2	38	0	-2	38	0	-2	38	0	-2	38	0	-2	38	0
-2	38	0	-2	38	0	-2	38	0	-2	38	0	-2	38	0	-2	38	0	-2	38	0	-2	38	0	-2	38	0	-2	38	0	-2	38	0	-2	38	0	-2	38	0	-2	38	0	-2	38	0	-2	38	0	-2	38	0	-2	38	0	-2	38	0	-2	38	0	-2	38	0	-2	38	0	-2	38	0	-2	38	0	-2	38	0	-2	38	0	-2	38	0	-2	38	0	-2	38	0	-2	38	0	-2	38	0	-2	38	0	-2	38	0	-2	38	0	-2	38	0	-2	38	0	-2	38	0	-2	38	0	-2	38	0	-2	38	0
-2	38	0	-2	38	0	-2	38	0	-2	38	0	-2	38	0	-2	38	0	-2	38	0	-2	38	0	-2	38	0	-2	38	0	-2	38	0	-2	38	0	-2	38	0	-2	38	0	-2	38	0	-2	38	0	-2	38	0	-2	38	0	-2	38	0	-2	38	0	-2	38	0	-2	38	0	-2	38	0	-2	38	0	-2	38	0	-2	38	0	-2	38	0	-2	38	0	-2	38	0	-2	38	0	-2	38	0	-2	38	0	-2	38	0	-2	38	0	-2	38	0	-2	38	0	-2	38	0	-2	38	0	-2	38	0	-2	38	0
-2	38	0	-2	38	0	-2	38	0	-2	38	0	-2	38	0	-2	38	0	-2	38	0	-2	38	0	-2	38	0	-2	38	0	-2	38	0	-2	38	0	-2	38	0	-2	38	0	-2	38	0	-2	38	0	-2	38	0	-2	38	0	-2	38	0	-2	38	0	-2	38	0	-2	38	0	-2	38	0	-2	38	0	-2	38	0	-2	38	0	-2	38	0	-2	38	0	-2	38	0	-2	38	0	-2	38	0	-2	38	0	-2	38	0	-2	38	0	-2	38	0	-2	38	0	-2	38	0	-2	38	0	-2	38	0	-2	38	0
-2	38	0	-2	38	0	-2	38	0	-2	38	0	-2	38	0	-2	38	0	-2	38	0	-2	38	0	-2	38	0	-2	38	0	-2	38	0	-2	38	0	-2	38	0	-2	38	0	-2	38	0	-2	38	0	-2	38	0	-2	38	0	-2	38	0	-2	38	0	-2	38	0	-2	38	0	-2	38	0	-2	38	0	-2	38	0	-2	38	0	-2	38	0	-2	38	0	-2	38	0	-2	38	0	-2	38	0	-2	38	0	-2	38	0	-2	38	0	-2	38	0	-2	38	0	-2	38	0	-2	38	0	-2	38	0	-2	38	0
-2	38	0	-2	38	0	-2	38	0	-2	38	0	-2	38	0	-2	38	0	-2	38	0	-2	38	0	-2	38	0	-2	38	0	-2	38	0	-2	38	0	-2	38	0	-2	38	0	-2	38	0	-2	38	0	-2	38	0	-2	38	0	-2	38	0	-2	38	0	-2	38	0	-2	38	0	-2	38	0	-2	38	0	-2	38	0	-2	38	0	-2	38	0	-2	38	0	-2	38	0	-2	38	0	-2	38	0	-2	38	0	-2	38	0	-2	38	0	-2	38	0	-2	38	0	-2	38	0	-2	38	0	-2	38	0	-2	38	0
-2	38	0	-2	38	0	-2	38	0	-2	38	0	-2	38	0	-2	38	0	-2	38	0	-2	38	0	-2	38	0	-2	38	0	-2	38	0	-2	38	0	-2	38	0	-2	38	0	-2	38	0	-2	38	0	-2	38	0	-2	38	0	-2	38	0	-2	38	0	-2	38	0	-2	38	0	-2	38	0	-2	38	0	-2	38	0	-2	38	0	-2	38	0	-2	38	0	-2	38	0	-2	38	0	-2	38	0	-2	38	0	-2	38	0	-2	38	0	-2	38	0	-2	38	0	-2	38	0	-2	38	0	-2	38	0	-2	38	0
-2	38	0	-2	38	0	-2	38	0	-2	38	0	-2	38	0	-2	38	0	-2	38	0	-2	38	0	-2	38	0	-2	38	0	-2	38	0	-2	38	0	-2	38	0	-2	38	0	-2	38	0	-2	38	0	-2	38	0	-2	38	0	-2	38	0	-2	38	0	-2	38	0	-2	38	0	-2	38	0	-2	38	0	-2	38	0	-2	38	0	-2	38	0	-2	38	0	-2	38	0	-2	38	0	-2	38	0	-2	38	0	-2	38	0	-2	38	0	-2	38	0	-2	38	0	-2	38	0	-2	38	0	-2	38	0	-2	38	0
-2	38	0	-2	38	0	-2	38	0	-2	38	0	-2	38	0	-2	38	0	-2	38	0	-2	38	0	-2	38	0	-2	38	0	-2	38	0	-2	38	0	-2	38	0	-2	38	0	-2	38	0	-2	38	0	-2	38	0	-2	38	0	-2	38	0	-2	38	0	-2	38	0	-2	38	0	-2	38	0	-2	38	0	-2	38	0	-2	38	0	-2	38	0	-2	38	0	-2	38	0	-2	38	0	-2	38	0	-2	38	0	-2	38	0	-2	38	0	-2	38	0	-2	38	0	-2	38	0	-2	38	0	-2	38	0	-2	38	0
-2	38	0	-2	38	0	-2	38	0	-2	38	0	-2	38	0	-2	38	0	-2	38	0	-2	38	0	-2	38	0	-2	38	0	-2	38	0	-2	38	0	-2	38	0	-2	38	0	-2	38	0	-2	38	0	-2	38	0	-2	38	0	-2	38	0	-2	38	0	-2	38	0	-2	38	0	-2	38	0	-2	38	0	-2	38	0	-2	38	0	-2	38	0	-2	38	0	-2	38	0	-2	38	0	-2	38	0	-2	38	0	-2	38	0	-2	38	0	-2	38	0	-2	38	0	-2	38	0	-2	38	0	-2	38	0	-2	38	0
-2	38	0	-2	38	0	-2	38	0	-2	38	0	-2	38	0	-2	38	0	-2	38	0	-2	38	0	-2	38	0	-2	38	0	-2	38	0	-2	38	0	-2	38	0	-2	38	0	-2	38	0	-2	38	0	-2	38	0	-2	38	0	-2	38	0	-2	38	0	-2	38	0	-2	38	0	-2	38	0	-2	38	0	-2	38	0	-2	38	0	-2	38	0	-2	38	0	-2	38	0	-2	38	0	-2	38	0	-2	38	0	-2	38	0	-2	38	0	-2	38	0	-2	38	0	-2	38	0	-2	38	0	-2	38	0	-2	38	0
-2	38	0	-2	38	0	-2	38	0	-2	38	0	-2	38	0	-2	38	0	-2	38	0	-2	38	0	-2	38	0	-2	38	0	-2	38	0	-2	38	0	-2	38	0	-2	38	0	-2	38	0	-2	38	0	-2	38	0	-2	38	0	-2	38	0	-2	38	0	-2	38	0	-2	38	0	-2	38	0	-2	38	0	-2	38	0	-2	38	0	-2	38	0	-2	38	0	-2	38	0	-2	38	0	-2	38	0	-2	38	0	-2	38	0	-2	38	0	-2	38	0	-2	38	0	-2	38	0	-2	38	0	-2	38	0	-2	38	0
-2	38	0	-2	38	0	-2	38	0	-2	38	0	-2	38	0	-2	38	0	-2	38	0	-2	38	0	-2	38	0	-2	38	0	-2	38	0	-2	38	0	-2	38	0	-2	38	0	-2	38	0	-2	38	0	-2	38	0	-2	38	0	-2	38	0	-2	38	0	-2	38	0	-2	38	0	-2	38	0	-2	38	0	-2	38	0	-2	38	0	-2	38	0	-2	38	0	-2	38	0	-2	38	0	-2	38	0	-2	38	0	-2	38	0	-2	38	0	-2	38	0	-2	38	0	-2	38	0	-2	38	0	-2	38	0	-2	38	0
-2	38	0	-2	38	0	-2	38	0	-2	38	0	-2	38	0	-2	38	0	-2	38	0	-2	38	0	-2	38	0	-2	38	0	-2	38	0	-2	38	0	-2	38	0	-2	38	0	-2	38	0	-2	38	0	-2	38	0	-2	38	0	-2	38	0	-2	38	0	-2	38	0	-2	38	0	-2	38	0	-2	38	0	-2	38	0	-2	38	0	-2	38	0	-2	38	0	-2	38	0	-2	38	0	-2	38	0	-2	38	0	-2	38	0	-2	38	0	-2	38	0	-2	38	0	-2	38	0	-2	38	0	-2	38	0	-2	38	0
-2	38	0	-2	38	0	-2	38	0	-2	38	0	-2	38	0	-2	38	0	-2	38	0	-2	38	0	-2	38	0	-2	38	0	-2	38	0	-2	38	0	-2	38	0	-2	38	0	-2	38	0	-2	38	0	-2	38	0	-2	38	0	-2	38	0	-2	38	0	-2	38	0	-2	38	0	-2	38	0	-2	38	0	-2	38	0	-2	38	0	-2	38	0	-2	38	0	-2	38	0	-2	38	0	-2	38	0	-2	38	0	-2	38	0	-2	38	0	-2	38	0	-2	38	0	-2	38	0	-2	38	0	-2	38	0	-2	38	0
-2	38	0	-2	38	0	-2	38	0	-2	38	0	-2	38	0	-2	38	0	-2	38	0	-2	38	0	-2	38	0	-2	38	0	-2	38	0	-2	38	0	-2	38	0	-2	38	0	-2	38	0	-2	38	0	-2	38	0	-2	38	0	-2	38	0	-2	38	0	-2	38	0	-2	38	0	-2	38	0	-2	38	0	-2	38	0	-2	38	0	-2	38	0	-2	38	0	-2	38	0	-2	38	0	-2	38	0	-2	38	0	-2	38	0	-2	38	0	-2	38	0	-2	38	0	-2	38	0	-2	38	0	-2	38	0	-2	38	0
-2	38	0	-2	38	0	-2	38	0	-2	38	0	-2	38	0	-2	38	0	-2	38	0	-2	38	0	-2	38	0	-2	38	0	-2	38	0	-2	38	0	-2	38	0	-2	38	0	-2	38	0	-2	38	0	-2	38	0	-2	38	0	-2	38	0	-2	38	0	-2	38	0	-2	38	0	-2	38	0	-2	38	0	-2	38	0	-2	38	0	-2	38	0	-2	38	0	-2	38	0	-2	38	0	-2	38	0	-2	38	0	-2	38	0	-2	38	0	-2	38	0	-2	38	0	-2	38	0	-2	38	0	-2	38	0	-2	38	0
-2	38	0	-2	38	0	-2	38	0	-2	38	0	-2	38	0	-2	38	0	-2	38	0	-2	38	0	-2	38	0	-2	38	0	-2	38	0	-2	38	0	-2	38	0	-2	38	0	-2	38	0	-2	38	0	-2	38	0	-2	38	0	-2	38	0	-2	38	0	-2	38	0	-2	38	0	-2	38	0	-2	38	0	-2	38	0	-2	38	0	-2	38	0	-2	38	0	-2	38	0	-2	38	0	-2	38	0	-2	38	0	-2	38	0	-2	38	0	-2	38	0	-2	38	0	-2	38	0	-2	38	0	-2	38	0	-2	38	0
-2	38	0	-2	38	0	-2	38	0	-2	38	0	-2	38	0	-2	38	0	-2	38	0	-2	38	0	-2	38	0	-2	38	0	-2	38	0	-2	38	0	-2	38	0	-2	38	0	-2	38	0	-2	38	0	-2	38	0	-2	38	0	-2	38	0	-2	38	0	-2	38	0	-2	38	0	-2	38	0	-2	38	0	-2	38	0	-2	38	0	-2	38	0	-2	38	0	-2	38	0	-2	38	0	-2	38	0	-2	38	0	-2	38	0	-2	38	0	-2	38	0	-2	38	0	-2	38	0	-2	38	0	-2	38	0	-2	38	0
-2	38	0	-2	38	0	-2	38	0	-2	38	0	-2	38	0	-2	38	0	-2	38	0	-2	38	0	-2	38	0	-2	38	0	-2	38	0	-2	38	0	-2	38	0	-2	38	0	-2	38	0	-2	38	0	-2	38	0	-2	38	0	-2	38	0	-2	38	0	-2	38	0	-2	38	0	-2	38	0	-2	38	0	-2	38	0	-2	38	0	-2	38	0	-2	38	0	-2	38	0	-2	38	0	-2	38	0	-2	38	0	-2	38	0	-2	38	0	-2	38	0	-2	38	0	-2	38	0	-2	38	0	-2	38	0	-2	38	0
-2	38	0	-2	38	0	-2	38	0	-2	38	0	-2	38	0	-2	38	0	-2	38	0	-2	38	0	-2	38	0	-2	38	0	-2	38	0	-2	38	0	-2	38	0	-2	38	0	-2	38	0	-2	38	0	-2	38	0	-2	38	0	-2	38	0	-2	38	0	-2	38	0	-2	38	0	-2	38	0	-2	38	0	-2	38	0	-2	38	0	-2	38	0	-2	38	0	-2	38	0	-2	38	0	-2	38	0	-2	38	0	-2	38	0	-2	38	0	-2	38	0	-2	38	0	-2	38	0	-2	38	0	-2	38	0	-2	38	0
-2	38	0	-2	38	0	-2	38	0	-2	38	0	-2	38	0	-2	38	0	-2	38	0	-2	38	0	-2	38	0	-2	38	0	-2	38	0	-2	38	0	-2	38	0	-2	38	0	-2	38	0	-2	38	0	-2	38	0	-2	38	0	-2	38	0	-2	38	0	-2	38	0	-2	38	0	-2	38	0	-2	38	0	-2	38	0	-2	38	0	-2	38	0	-2	38	0	-2	38	0	-2	38	0	-2	38	0	-2	38	0	-2	38	32	-2	38	36	-2	38	68	-2	38	64	-2	38	0	-2	38	0	-2	38	0	-2	38	0
-2	38	0	-2	38	0	-2	38	0	-2	38	0	-2	38	0	-2	38	0	-2	38	0	-2	38	0	-2	38	0	-2	38	0	-2	38	0	-2	38	0	-2	38	0	-2	38	0	-2	38	0	-2	38	0	-2	38	0	-2	38	0	-2	38	0	-2	38	0	-2	38	0	-2	38	0	-2	38	0	-2	38	0	-2	38	0	-2	38	0	-2	38	0	-2	38	0	-2	38	0	-2	38	0	-2	38	0	-2	38	0	-2	38	2	3	6	1	3	6	0	-2	38	8	-2	38	0	-2	38	0	-2	38	0	-2	38	0
