-2	16	0	-2	16	0	-2	16	0	-2	16	0	-2	16	0	-2	16	0	-2	16	0	-2	16	0	-2	16	0	-2	16	0	-2	16	0	-2	16	0	-2	16	0	-2	16	0	-2	16	0	-2	16	0	-2	16	0	-2	16	0	-2	16	0	-2	16	0	-2	16	0	-2	16	0	-2	16	0	-2	16	0	-2	16	0	-2	16	0	-2	16	0	-2	16	0	-2	16	0	-2	16	0	-2	16	0	-2	16	0	-2	16	0	-2	16	0	-2	16	0	-2	16	0	-2	16	0	-2	16	0	-2	16	0	-2	16	0
-2	16	0	-2	16	0	-2	16	0	-2	16	0	-2	16	0	-2	16	0	-2	16	0	-2	16	0	-2	16	0	-2	16	0	-2	16	0	-2	16	0	-2	16	0	-2	16	0	-2	16	0	-2	16	0	-2	16	0	-2	16	0	-2	16	0	-2	16	0	-2	16	0	-2	16	0	-2	16	0	-2	16	0	-2	16	0	-2	16	0	-2	16	0	-2	16	0	-2	16	0	-2	16	0	-2	16	0	-2	16	0	-2	16	0	-2	16	0	-2	16	0	-2	16	0	-2	16	0	-2	16	0	-2	16	0	-2	16	0
-2	16	0	-2	16	0	-2	16	0	-2	16	0	-2	16	0	-2	16	0	-2	16	0	-2	16	0	-2	16	0	-2	16	0	-2	16	0	-2	16	0	-2	16	0	-2	16	0	-2	16	0	-2	16	0	-2	16	0	-2	16	0	-2	16	0	-2	16	0	-2	16	0	-2	16	0	-2	16	0	-2	16	0	-2	16	0	-2	16	0	-2	16	0	-2	16	0	-2	16	0	-2	16	0	-2	16	0	-2	16	0	-2	16	0	-2	16	0	-2	16	0	-2	16	0	-2	16	0	-2	16	0	-2	16	0	-2	16	0
-2	16	0	-2	16	0	-2	16	0	-2	16	0	-2	16	0	-2	16	0	-2	16	0	-2	16	0	-2	16	0	-2	16	0	-2	16	0	-2	16	0	-2	16	0	-2	16	0	-2	16	0	-2	16	0	-2	16	0	-2	16	0	-2	16	0	-2	16	0	-2	16	0	-2	16	0	-2	16	0	-2	16	0	-2	16	0	-2	16	0	-2	16	0	-2	16	0	-2	16	0	-2	16	0	-2	16	0	-2	16	0	-2	16	0	-2	16	0	-2	16	0	-2	16	0	-2	16	0	-2	16	0	-2	16	0	-2	16	0
-2	16	0	-2	16	0	-2	16	0	-2	16	0	-2	16	0	-2	16	0	-2	16	0	-2	16	0	-2	16	0	-2	16	0	-2	16	0	-2	16	0	-2	16	0	-2	16	0	-2	16	0	-2	16	0	-2	16	0	-2	16	0	-2	16	0	-2	16	0	-2	16	0	-2	16	0	-2	16	0	-2	16	0	-2	16	0	-2	16	0	-2	16	0	-2	16	0	-2	16	0	-2	16	0	-2	16	0	-2	16	0	-2	16	0	-2	16	0	-2	16	0	-2	16	0	-2	16	0	-2	16	0	-2	16	0	-2	16	0
-2	16	0	-2	16	0	-2	16	0	-2	16	0	-2	16	0	-2	16	0	-2	16	0	-2	16	0	-2	16	0	-2	16	0	-2	16	0	-2	16	0	-2	16	0	-2	16	0	-2	16	0	-2	16	0	-2	16	0	-2	16	0	-2	16	0	-2	16	0	-2	16	0	-2	16	0	-2	16	0	-2	16	0	-2	16	0	-2	16	0	-2	16	0	-2	16	0	-2	16	0	-2	16	0	-2	16	0	-2	16	0	-2	16	0	-2	16	0	-2	16	0	-2	16	0	-2	16	0	-2	16	0	-2	16	0	-2	16	0
-2	16	0	-2	16	0	-2	16	0	-2	16	0	-2	16	0	-2	16	0	-2	16	0	-2	16	0	-2	16	0	-2	16	0	-2	16	0	-2	16	0	-2	16	0	-2	16	0	-2	16	0	-2	16	0	-2	16	0	-2	16	0	-2	16	0	-2	16	0	-2	16	0	-2	16	0	-2	16	0	-2	16	0	-2	16	0	-2	16	0	-2	16	0	-2	16	0	-2	16	0	-2	16	0	-2	16	0	-2	16	0	-2	16	0	-2	16	0	-2	16	0	-2	16	0	-2	16	0	-2	16	0	-2	16	0	-2	16	0
-2	16	0	-2	16	0	-2	16	0	-2	16	0	-2	16	0	-2	16	0	-2	16	0	-2	16	0	-2	16	0	-2	16	32	-2	16	36	-2	16	100	-2	16	68	-2	16	64	-2	16	0	-2	16	0	-2	16	0	-2	16	0	-2	16	0	-2	16	0	-2	16	0	-2	16	0	-2	16	0	-2	16	0	-2	16	0	-2	16	0	-2	16	0	-2	16	0	-2	16	0	-2	16	0	-2	16	0	-2	16	0	-2	16	0	-2	16	0	-2	16	0	-2	16	0	-2	16	0	-2	16	0	-2	16	0	-2	16	0
-2	16	0	-2	16	0	-2	16	0	-2	16	0	-2	16	0	-2	16	0	-2	16	0	-2	16	0	-2	16	0	-2	16	34	-2	52	9	-2	52	1	-2	52	3	-2	16	72	-2	16	0	-2	16	0	-2	16	0	-2	16	0	-2	16	0	-2	16	0	-2	16	0	-2	16	0	-2	16	0	-2	16	0	-2	16	0	-2	16	0	-2	16	0	-2	16	0	-2	16	0	-2	16	0	-2	16	0	-2	16	0	-2	16	0	-2	16	0	-2	16	0	-2	16	0	-2	16	0	-2	16	0	-2	16	0	-2	16	0
-2	16	0	-2	16	0	-2	16	0	-2	16	0	-2	16	0	-2	16	0	-2	16	0	-2	16	0	-2	16	0	-2	16	50	-2	52	8	-2	52	0	-2	52	2	-2	16	-56	-2	16	0	-2	16	0	-2	16	0	-2	16	0	-2	16	0	-2	16	0	-2	16	0	-2	16	0	-2	16	0	-2	16	0	-2	16	0	-2	16	0	-2	16	0	-2	16	0	-2	16	0	-2	16	0	-2	16	0	-2	16	0	-2	16	0	-2	16	0	-2	16	0	-2	16	0	-2	16	0	-2	16	0	-2	16	0	-2	16	0
-2	16	0	-2	16	0	-2	16	0	-2	16	0	-2	16	0	-2	16	0	-2	16	0	-2	16	0	-2	16	0	-2	16	50	-2	52	12	-2	52	4	-2	52	6	-2	16	-56	-2	16	0	-2	16	0	-2	16	0	-2	16	0	-2	16	0	-2	16	0	-2	16	0	-2	16	0	-2	16	0	-2	16	0	-2	16	0	-2	16	0	-2	16	0	-2	16	0	-2	16	0	-2	16	0	-2	16	0	-2	16	0	-2	16	0	-2	16	0	-2	16	0	-2	16	0	-2	16	0	-2	16	0	-2	16	0	-2	16	0
-2	16	0	-2	16	0	-2	16	0	-2	16	0	-2	16	0	-2	16	0	-2	16	0	-2	16	0	-2	16	0	-2	16	50	-2	61	9	-2	61	1	-2	61	3	-2	16	-56	-2	16	0	-2	16	0	-2	16	0	-2	16	0	-2	16	0	-2	16	0	-2	16	0	-2	16	0	-2	16	0	-2	16	0	-2	16	0	-2	16	0	-2	16	0	-2	16	0	-2	16	0	-2	16	0	-2	16	0	-2	16	0	-2	16	0	-2	16	0	-2	16	0	-2	16	0	-2	16	0	-2	16	0	-2	16	0	-2	16	0
-2	16	0	-2	16	0	-2	16	0	-2	16	0	-2	16	0	-2	16	0	-2	16	0	-2	16	0	-2	16	0	-2	16	50	-2	61	8	-2	61	0	-2	61	2	-2	16	-56	-2	16	0	-2	16	0	-2	16	0	-2	16	0	-2	16	0	-2	16	0	-2	16	0	-2	16	0	-2	16	0	-2	16	0	-2	16	0	-2	16	0	-2	16	0	-2	16	0	-2	16	0	-2	16	0	-2	16	0	-2	16	0	-2	16	0	-2	16	0	-2	16	0	-2	16	0	-2	16	0	-2	16	0	-2	16	0	-2	16	0
-2	16	0	-2	16	0	-2	16	0	-2	16	0	-2	16	0	-2	16	0	-2	16	0	-2	16	0	-2	16	0	-2	16	50	-2	61	8	-2	61	0	-2	61	2	-2	16	-56	-2	16	0	-2	16	0	-2	16	0	-2	16	0	-2	16	0	-2	16	0	-2	16	0	-2	16	0	-2	16	0	-2	16	0	-2	16	0	-2	16	0	-2	16	0	-2	16	0	-2	16	0	-2	16	0	-2	16	0	-2	16	0	-2	16	0	-2	16	0	-2	16	0	-2	16	0	-2	16	0	-2	16	0	-2	16	0	-2	16	0
-2	16	0	-2	16	0	-2	16	0	-2	16	0	-2	16	0	-2	16	0	-2	16	0	-2	16	0	-2	16	0	-2	16	50	-2	61	8	-2	61	0	-2	61	2	-2	16	-56	-2	16	0	-2	16	0	-2	16	0	-2	16	0	-2	16	0	-2	16	0	-2	16	0	-2	16	0	-2	16	0	-2	16	0	-2	16	0	-2	16	0	-2	16	0	-2	16	0	-2	16	0	-2	16	0	-2	16	0	-2	16	0	-2	16	0	-2	16	0	-2	16	0	-2	16	0	-2	16	0	-2	16	0	-2	16	0	-2	16	0
-2	16	0	-2	16	0	-2	16	0	-2	16	0	-2	16	0	-2	16	0	-2	16	0	-2	16	0	-2	16	0	-2	16	50	-2	61	12	-2	61	4	-2	61	6	-2	16	-56	-2	16	0	-2	16	0	-2	16	0	-2	16	0	-2	16	0	-2	16	0	-2	16	0	-2	16	0	-2	16	0	-2	16	0	-2	16	0	-2	16	0	-2	16	0	-2	16	0	-2	16	0	-2	16	0	-2	16	0	-2	16	0	-2	16	0	-2	16	0	-2	16	0	-2	16	0	-2	16	0	-2	16	0	-2	16	0	-2	16	0
-2	16	0	-2	16	0	-2	16	0	-2	16	0	-2	16	0	-2	16	0	-2	16	0	-2	16	0	-2	16	0	-2	16	50	-2	61	8	-2	16	123	-2	61	2	-2	16	-56	-2	16	0	-2	16	0	-2	16	0	-2	16	0	-2	16	0	-2	16	0	-2	16	0	-2	16	0	-2	16	0	-2	16	0	-2	16	0	-2	16	0	-2	16	0	-2	16	0	-2	16	0	-2	16	0	-2	16	0	-2	16	0	-2	16	0	-2	16	0	-2	16	0	-2	16	0	-2	16	0	-2	16	0	-2	16	0	-2	16	0
-2	16	0	-2	16	0	-2	16	0	-2	16	0	-2	16	0	-2	16	0	-2	16	0	-2	16	0	-2	16	0	-2	16	18	-2	61	12	-2	16	-102	-2	61	6	-2	16	-120	-2	16	0	-2	16	0	-2	16	0	-2	16	0	-2	16	0	-2	16	0	-2	16	0	-2	16	0	-2	16	0	-2	16	0	-2	16	0	-2	16	0	-2	16	0	-2	16	0	-2	16	0	-2	16	0	-2	16	0	-2	16	0	-2	16	0	-2	16	0	-2	16	0	-2	16	0	-2	16	0	-2	16	0	-2	16	0	-2	16	0
-2	16	0	-2	16	0	-2	16	0	-2	16	0	-2	16	0	-2	16	0	-2	16	0	-2	16	0	-2	16	0	-2	16	16	-2	16	1	-2	16	-112	-2	16	1	-2	16	-128	-2	16	0	-2	16	0	-2	16	0	-2	16	0	-2	16	0	-2	16	0	-2	16	0	-2	16	0	-2	16	0	-2	16	0	-2	16	0	-2	16	0	-2	16	0	-2	16	0	-2	16	0	-2	16	0	-2	16	0	-2	16	0	-2	16	0	-2	16	0	-2	16	0	-2	16	0	-2	16	0	-2	16	0	-2	16	0	-2	16	0
-2	16	0	-2	16	0	-2	16	0	-2	16	0	-2	16	0	-2	16	0	-2	16	0	-2	16	0	-2	16	0	-2	16	0	-2	16	0	-2	16	0	-2	16	0	-2	16	0	-2	16	0	-2	16	0	-2	16	0	-2	16	0	-2	16	0	-2	16	0	-2	16	0	-2	16	0	-2	16	0	-2	16	0	-2	16	0	-2	16	0	-2	16	0	-2	16	0	-2	16	0	-2	16	0	-2	16	0	-2	16	0	-2	16	0	-2	16	0	-2	16	0	-2	16	0	-2	16	0	-2	16	0	-2	16	0	-2	16	0
-2	16	0	-2	16	0	-2	16	0	-2	16	0	-2	16	0	-2	16	0	-2	16	0	-2	16	0	-2	16	0	-2	16	0	-2	16	0	-2	16	0	-2	16	0	-2	16	0	-2	16	0	-2	16	0	-2	16	0	-2	16	0	-2	16	0	-2	16	0	-2	16	0	-2	16	0	-2	16	0	-2	16	0	-2	16	0	-2	16	0	-2	16	0	-2	16	0	-2	16	0	-2	16	0	-2	16	0	-2	16	0	-2	16	0	-2	16	0	-2	16	0	-2	16	0	-2	16	0	-2	16	0	-2	16	0	-2	16	0
-2	16	0	-2	16	0	-2	16	0	-2	16	0	-2	16	0	-2	16	0	-2	16	0	-2	16	0	-2	16	0	-2	16	0	-2	16	0	-2	16	0	-2	16	0	-2	16	0	-2	16	0	-2	16	0	-2	16	0	-2	16	0	-2	16	0	-2	16	0	-2	16	0	-2	16	0	-2	16	0	-2	16	0	-2	16	0	-2	16	0	-2	16	0	-2	16	0	-2	16	0	-2	16	0	-2	16	0	-2	16	0	-2	16	0	-2	16	0	-2	16	0	-2	16	0	-2	16	0	-2	16	0	-2	16	0	-2	16	0
-2	16	0	-2	16	0	-2	16	0	-2	16	0	-2	16	0	-2	16	0	-2	16	0	-2	16	0	-2	16	0	-2	16	0	-2	16	0	-2	16	0	-2	16	0	-2	16	0	-2	16	0	-2	16	0	-2	16	0	-2	16	0	-2	16	0	-2	16	0	-2	16	0	-2	16	0	-2	16	0	-2	16	0	-2	16	0	-2	16	0	-2	16	0	-2	16	0	-2	16	0	-2	16	0	-2	16	0	-2	16	0	-2	16	0	-2	16	0	-2	16	0	-2	16	0	-2	16	0	-2	16	0	-2	16	0	-2	16	0
-2	16	0	-2	16	0	-2	16	0	-2	16	0	-2	16	0	-2	16	0	-2	16	0	-2	16	0	-2	16	0	-2	16	0	-2	16	0	-2	16	0	-2	16	0	-2	16	0	-2	16	0	-2	16	0	-2	16	0	-2	16	0	-2	16	0	-2	16	0	-2	16	0	-2	16	0	-2	16	0	-2	16	0	-2	16	0	-2	16	0	-2	16	0	-2	16	0	-2	16	0	-2	16	0	-2	16	0	-2	16	0	-2	16	0	-2	16	0	-2	16	0	-2	16	0	-2	16	0	-2	16	0	-2	16	0	-2	16	0
-2	16	0	-2	16	0	-2	16	0	-2	16	0	-2	16	0	-2	16	0	-2	16	0	-2	16	0	-2	16	0	-2	16	0	-2	16	0	-2	16	0	-2	16	0	-2	16	0	-2	16	0	-2	16	0	-2	16	0	-2	16	0	-2	16	0	-2	16	0	-2	16	0	-2	16	0	-2	16	0	-2	16	0	-2	16	0	-2	16	0	-2	16	0	-2	16	0	-2	16	0	-2	16	0	-2	16	0	-2	16	0	-2	16	0	-2	16	0	-2	16	0	-2	16	0	-2	16	0	-2	16	0	-2	16	0	-2	16	0
-2	16	0	-2	16	0	-2	16	0	-2	16	0	-2	16	0	-2	16	0	-2	16	0	-2	16	0	-2	16	0	-2	16	0	-2	16	0	-2	16	0	-2	16	0	-2	16	0	-2	16	0	-2	16	0	-2	16	0	-2	16	0	-2	16	0	-2	16	0	-2	16	0	-2	16	0	-2	16	0	-2	16	0	-2	16	0	-2	16	0	-2	16	0	-2	16	0	-2	16	0	-2	16	0	-2	16	0	-2	16	0	-2	16	0	-2	16	0	-2	16	0	-2	16	0	-2	16	0	-2	16	0	-2	16	0	-2	16	0
-2	16	0	-2	16	0	-2	16	0	-2	16	0	-2	16	0	-2	16	0	-2	16	0	-2	16	0	-2	16	0	-2	16	0	-2	16	0	-2	16	0	-2	16	0	-2	16	0	-2	16	0	-2	16	0	-2	16	0	-2	16	0	-2	16	0	-2	16	0	-2	16	0	-2	16	0	-2	16	0	-2	16	0	-2	16	0	-2	16	0	-2	16	0	-2	16	0	-2	16	0	-2	16	0	-2	16	0	-2	16	0	-2	16	0	-2	16	0	-2	16	0	-2	16	0	-2	16	0	-2	16	0	-2	16	0	-2	16	0
-2	16	0	-2	16	0	-2	16	0	-2	16	0	-2	16	0	-2	16	0	-2	16	0	-2	16	0	-2	16	0	-2	16	0	-2	16	0	-2	16	0	-2	16	0	-2	16	0	-2	16	0	-2	16	0	-2	16	0	-2	16	0	-2	16	0	-2	16	0	-2	16	0	-2	16	0	-2	16	0	-2	16	0	-2	16	0	-2	16	0	-2	16	0	-2	16	0	-2	16	0	-2	16	0	-2	16	0	-2	16	0	-2	16	0	-2	16	0	-2	16	0	-2	16	0	-2	16	0	-2	16	0	-2	16	0	-2	16	0
-2	16	0	-2	16	0	-2	16	0	-2	16	0	-2	16	0	-2	16	0	-2	16	0	-2	16	0	-2	16	0	-2	16	0	-2	16	0	-2	16	0	-2	16	0	-2	16	0	-2	16	0	-2	16	0	-2	16	0	-2	16	0	-2	16	0	-2	16	0	-2	16	0	-2	16	0	-2	16	0	-2	16	0	-2	16	0	-2	16	0	-2	16	0	-2	16	0	-2	16	0	-2	16	0	-2	16	0	-2	16	0	-2	16	0	-2	16	0	-2	16	0	-2	16	0	-2	16	0	-2	16	0	-2	16	0	-2	16	0
-2	16	0	-2	16	0	-2	16	0	-2	16	0	-2	16	0	-2	16	0	-2	16	0	-2	16	0	-2	16	0	-2	16	0	-2	16	0	-2	16	0	-2	16	0	-2	16	0	-2	16	0	-2	16	0	-2	16	0	-2	16	0	-2	16	0	-2	16	0	-2	16	0	-2	16	0	-2	16	0	-2	16	0	-2	16	0	-2	16	0	-2	16	0	-2	16	0	-2	16	0	-2	16	0	-2	16	0	-2	16	0	-2	16	0	-2	16	0	-2	16	0	-2	16	0	-2	16	0	-2	16	0	-2	16	0	-2	16	0
